#########################
#{.....................o#
#o......M..............o#
#.######.........######.#
  #    #.### ###.#    #. 
 .#    #.#     #.#    #. 
#.######.#######.######.#
#oM....................o#
#########################
